111111111111111111111111
1000000000000000000000P1
110000C0000000000C000111
100001111111000000000011
110000111000000000000011
100C00000000001111111111
1000000000C00000110000E1
100000000000000000000001
111111001111111111111111
11100000000001110C001111
100001111111111100000011
100111100111001111100011
110100000001100001101001
110110111011001100001101
110000000000011111111011
11100C000000000110000001
11000000000C0000000C0001
111111111111111111111111
