111111111111111111111111
1000000000000000000000P1
110000C0000000000C000111
100001111111000000000011
110000111000000000000011
100C00000000001111111111
1000000000C00000110000E1
100000000000000000000001
111111111111111111111111
